................................
................................
................................
................................
................................
................................
................................
................................
................................
................................
................................
................................
................................
................................
P...............CCCCCCC.........
################################